каттин: каттино 
снизиться: снизилась 
место: место 
вернуться: вернуться вернулся вернется 
впервые: впервые 
пятёрка: пятёрку пятёрки пятерку 
смит: смит 
подходить: подходил 
шаг: шаг 
команда: команды командой команда команду команде 
мэриленд: мэриленда мэриленде мэриленд 
разыгрывать: разыгрывающего разыгрывающий 
майами: майами 
й: й 
страница: страница 
подбор: подборы подборов 
вес: вес 
иметь: имели 
передача: передачи передач 
срок: срока 
момент: момент 
нога: ноги 
гарден: гарден 
завершить: завершила завершив завершил 
наггетс: наггетс 
трейся: трейси 
они: ними 
несмотря: несмотря 
удовлетворить: удовлетворено 
джаз: джаз 
пятница: пятницу 
элтон: элтоном 
баскетбольный: баскетбольная 
монтгомери: монтгомери 
слух: слухи 
использовать: использовал 
позволить: позволил 
вновь: вновь 
внимание: внимание 
менее: менее 
обратно: обратно 
рост: рост 
очко: очков очка 
ченнинга: ченнинг 
лейкерс: лейкерс 
родный: родного 
террапинс: террапинс 
знак: знак 
набрать: набрав набрал 
стать: стала стал 
колледж: колледжах колледж 
третий: третьем третий 
смочь: смогли смог 
попасть: попали попал 
отказаться: отказался 
участник: участник 
дом: дома 
проиграть: проиграли 
западный: западной 
год: года году год лет 
университет: университет университета 
водяной: водяные 
один: одну одной 
тренировочный: тренировочного 
кельвин: кельвина 
данк: данк 
отдельный: отдельных 
подписать: подписав подписал 
позиция: позиция 
двухлетний: двухлетний 
экс: экс 
набирать: набирал набирая 
действовать: действовать 
игра: игр игры игру играх 
который: который 
курсор: курсор 
защитник: защитника защитником защитник 
драфт: драфта драфт драфте 
томьянович: томьянович 
сожаление: сожалению 
первый: первого первые первом 
никакой: никакие 
тендинит: тендинит 
преемник: преемника 
практически: практически 
неограниченно: неограниченно 
занять: занять занял 
получить: получил 
вместе: вместе 
джента: джента 
личный: личные 
лига: лиге 
бэйцзина: бэйцзин 
атаковать: атакующий атакующим атакующего 
родиться: родился 
аббревиатура: аббревиатуры 
свой: своего своих своей своем 
перевести: переведён 
однако: однако 
третьекурсник: третьекурсником 
божий: божьей 
звание: звание 
маверикс: маверикс 
звезда: звёзд 
эрл: эрла 
википедия: википедии 
ганди: ганди 
прежде: прежде 
гражданство: гражданство 
обучаться: обучался 
стартовый: стартовую стартовой 
сыграть: сыграл 
установить: установил 
нападение: нападения 
денвер: денвер 
результат: результатом результате 
агент: агентом 
быстрый: быстрый 
тренер: тренера тренер 
дебютировать: дебютировал 
очки: очки 
мег: мега 
травма: травму травмы 
случай: случаях 
чемпионат: чемпионата 
март: марта 
свободный: свободным свободной 
очевидный: очевидно 
джуван: джуван 
налог: налогами налог 
итог: итоге итогам 
остаться: оставшиеся 
бросок: бросок 
ховард: ховард 
генменеджер: генменеджер 
крупный: крупный 
заинтересовать: заинтересованы 
ссылка: ссылки 
предложить: предложили 
парк: парк 
следующий: следующем 
блэр: блэр 
товарный: товарный 
дешон: дешон 
закончить: закончили 
тренерский: тренерский 
профессиональный: профессиональный 
хотя: хотя 
сообщить: сообщено 
спринг: спринг 
возвращение: возвращение 
обменять: обменяли обменян обменял 
вашингтон: вашингтон 
начало: начале 
больший: большим 
фред: фреда 
лагерь: лагеря 
направление: направлении 
пенни: пенни 
участвие: участвия 
фрая: фрая 
таки: таки 
рекорд: рекорд 
фунт: фунтов 
соединить: соединенные 
сезон: сезон сезоне сезона 
источник: источник 
ариз: аризу 
навести: наведите 
организация: организации 
соответствовать: соответствовал 
таком: такома 
студенческий: студенческого студенческая 
разделить: разделил 
пять: пяти 
снизить: снизить 
пропустить: пропустили 
мемфис: мемфисе 
впоследствии: впоследствии 
очковый: очковый 
рик: рика 
публично: публично 
июнь: июня 
участвовать: участвовал 
период: периода 
китайский: китайского китайская 
конечный: конечном 
интерес: интерес 
хьюстон: хьюстон хьюстоне 
минута: минут 
мышь: мыши 
стив: стив стива 
доступный: доступен 
клипперс: клипперс 
раунд: раунд 
черепаха: черепахи 
потерять: потерял 
выбрать: выбран выбрали выбрал выбрала 
заголовок: заголовке 
таблица: таблицы 
кг: кг 
уотсон: уотсона 
деньга: денег 
награда: награды 
штат: штаты 
ноябрь: ноябре 
номер: номером 
главный: главный 
регулярный: регулярный 
фрэнсис: фрэнсису фрэнсис фрэнсиса фрэнсисом 
матч: матче матч матча матчи 
стиль: стилю стиль 
отобрать: отобран 
баскетболист: баскетболист 
конец: конце 
тайрон: тайрон 
ассоциация: ассоциация 
анферня: анферни 
контест: контесте 
расстроить: расстроило 
улучшиться: улучшился 
расставаться: расставаться 
играть: играя играл играть 
второй: вторым 
достижение: достижения 
сборная: сборная 
обмен: обменом обмен 
условие: условия 
джонс: джонса 
середина: середине 
ход: ходе 
г: г 
шота: шоты 
находиться: находилась 
главное: главного 
сквер: сквер 
сразу: сразу 
центровой: центрового 
мочь: могут 
общий: общим 
рис: риса 
январь: января 
среда: среде 
викисклад: викискладе 
прочесть: прочесть 
июль: июля 
лицензия: лицензии 
быть: будучи 
дополнительный: дополнительные 
лос: лос 
окончание: окончании окончания 
нба: нба 
новичок: новичок новичков новичка 
другой: другие 
ухудшиться: ухудшились 
рокетс: рокетс 
содержание: содержание 
школа: школа 
аллеганя: аллегани 
развеять: развеяны 
дико: дико 
состав: составе 
перехват: перехваты перехватов 
смотреть: см 
уйти: ушел 
данков: данков 
брэнд: брэндом 
воля: волей 
старт: старте 
дэн: дэн 
включить: включены 
забросить: забросил 
состояние: состоянии 
пребывание: пребывания 
показатель: показатель 
хороший: лучшим лучших 
желание: желание 
отис: отис 
макгрейти: макгрейди 
победа: победами 
новый: новой 
игрок: игроков 
декабрь: декабря 
сделка: сделки 
мина: мина мине 
мэдисон: мэдисон 
нетс: нетс 
дакс: дакс 
всеамериканский: всеамериканская 
дата: дата 
включать: включавшей 
контракт: контракта контракте контракт 
четыре: четыре 
связка: связка 
продать: продан 
этот: эта 
рэндольф: рэндольфа 
друг: другом 
лить: лью 
победный: победный 
день: день 
сша: сша 
хит: хит 
недовольный: недоволен 
появиться: появились 
отставка: отставку 
х: х 
объяснять: объясняя 
като: като 
подряд: подряд 
столкнуться: столкнулись 
медиафайл: медиафайлы 
затем: затем 
хотеть: хотел хочет 
карьера: карьера карьеру карьеры 
ротация: ротации 
пик: пик пика 
расстояние: расстоянием 
роскошь: роскошь 
адаптироваться: адаптировался 
заявить: заявил 
джефф: джеффа 
отредактировать: отредактирована 
проявить: проявили 
удаться: удалось 
крис: криса 
объявить: объявил 
расшифровка: расшифровку 
блок: блок 
также: также 
ванкувер: ванкувер 
отношение: отношения 
планировать: планирует 
самый: самый 
нью: нью 
мэджик: мэджик 
поражение: поражениях 
моблить: мобли 
яо: яо 
история: истории 
выкупить: выкупил 
гейнс: гейнса 
зарегистрировать: зарегистрированный 
сделать: сделало 
плей: плей 
май: мая 
сайт: сайте 
уизардс: уизардс 
упасть: упав 
каролина: каролины 
джерси: джерси 
опция: опцию 
никс: никс 
оба: оба 
миннесота: миннесота 
американский: американский 
серия: серия 
покинуть: покинуть 
выбраться: выбраться 
сильный: сильнейших 
временной: временного 
среднее: среднем 
джакинто: джакинто 
трэйл: трэйл 
колено: колене 
портленд: портленд 
забить: забив 
очень: очень 
дебютный: дебютного 
анджелес: анджелес 
скоростной: скоростному 
право: правом 
двигаться: двигаться 
френсиса: френсиса 
местный: местной 
ван: ван 
последний: последний 
текст: текст 
материал: материал 
рождение: рождения 
сосредоточить: сосредоточить 
сан: сан 
гриззлис: гриззлис 
хардуэй: хардуэй 
потеря: потери 
начать: начал 
против: против 
истекать: истекающий 
дедлайн: дедлайна 
прошлый: прошлом 
рудить: руди 
качество: качестве 
зак: зака 
блэйзерс: блэйзерс 
февраль: февраля 
англ: англ 
это: это 
орландо: орландо 
силвера: силвер 
стремиться: стремился 
бывший: бывшей 
адельмана: адельмана 
энциклопедия: энциклопедии 
статистика: статистика 
лишь: лишь 
даллас: даллас 
восстановление: восстановления 
должное: должное 
йорк: йорк 
некоммерческий: некоммерческой 
отобраться: отобраться 
время: время 
офф: офф 
второе: второе 
ют: юта 
профиль: профиль 
млн: млн 
выиграть: выиграть 
условный: условного 
прозвище: прозвища 
слэм: слэм 
