кроме: кроме 
лиственный: лиственных 
однотонный: однотонным 
страна: странах 
резкий: резким 
условие: условия 
снизить: снижена 
торец: торце 
переработка: переработку 
лесна: лесн 
вид: виде видов вид 
лесосплав: лесосплаве 
деятельность: деятельностью деятельность 
физический: физические 
правило: правило 
промежуточный: промежуточное 
плохо: плохо 
вызвать: вызван 
заметный: заметную 
встречаться: встречаются встречается встречающаяся 
объяснять: объясняют 
близкий: ближе 
внешний: внешний внешним 
отлупный: отлупных 
стекловидный: стекловидных 
сосна: сосны 
состояние: состоянии 
часто: часто 
крение: кренью 
осина: осины 
зарегистрировать: зарегистрированный 
особенно: особенно 
пихтовый: пихтовая 
страница: страница 
случай: случаях 
изд: изд 
знак: знак 
отрицательный: отрицательной 
водосло: водосло 
среднее: среднем 
доп: доп 
загнивание: загнивания 
изгиб: изгибе 
пятнистость: пятнистости 
удлинение: удлинение 
разновидность: разновидность 
предположение: предположения 
чехол: чехлу 
количество: количества 
высыхание: высыхания 
американский: американских 
распространить: распространенных распространён 
древесина: древесиной древесины древесине древесина 
трескаться: трескаться 
впитывание: впитывании 
организация: организации 
свойство: свойство свойства 
направление: направлении 
сравнительно: сравнительно 
также: также 
отлуп: отлупы 
резко: резко 
видимый: видимой видимые 
водослойный: водослойной водослойная 
механизм: механизм 
вместе: вместе 
частый: чаще 
структура: структуру 
порок: пороки порока пороков 
очаг: очагами очагов 
лес: лесах 
бактерия: бактериями бактерий 
характерный: характерен характерную 
усыхать: усыхать 
образоваться: образуются образующийся 
дерево: дереве 
утоп: утопа 
й: й 
плотность: плотности 
энциклопедия: энциклопедии 
подтверждаться: подтверждается 
важный: важной 
всасывание: всасывания 
мокрый: мокрых 
водопроницаемость: водопроницаемости 
влажный: влажном 
занимать: занимает 
равноценный: равноценна 
радиальный: радиальной радиальном 
материал: материал 
такой: такая 
вызывать: вызывая 
перераб: перераб 
величина: величиной величины 
прочность: прочность прочности 
специфический: специфическая 
кряж: кряжи кряжей 
заболонь: заболонью 
достигать: достигает 
участок: участок участках 
способ: способы 
миллер: миллер 
отсутствовать: отсутствует 
спелый: спелой 
доказать: доказана 
плохой: худший 
данный: данного 
последний: последний 
разжижение: разжижение 
мёрзлый: мёрзлых 
годичный: годичному 
расстояние: расстояние 
вакин: вакин 
гриб: грибов 
механический: механические механическая 
почва: почвах 
водослоить: водослоя 
тёмный: тёмно тёмным тёмный тёмных 
смотреть: см 
сырой: сырого 
тополь: тополей 
сочетание: сочетании 
существовать: существуют 
гниль: гнили 
обычно: обычно 
соловей: соловьёв 
корень: корнями 
повышенный: повышенным 
википедия: википедии 
свободный: свободной 
л: л 
бактериальный: бактериальная 
измерение: измерения 
серый: серым серый 
светлый: светлым светлый 
ударный: ударных ударная 
чрезмерный: чрезмерного 
называть: называемая 
доступный: доступен 
подобно: подобно 
м: м 
неравномерно: неравномерно 
споруляция: споруляцией 
выдержать: выдержанной 
сопредельный: сопредельных 
располагаться: располагаясь располагается 
являться: является 
признак: признаками признакам 
распространяться: распространяться 
простираться: простирающийся 
отредактировать: отредактирована 
определяться: определяется 
сопровождаться: сопровождается 
рн: рн 
гипотеза: гипотез 
дата: дата 
гост: гост 
статический: статическом 
вязкость: вязкость 
этот: эта 
текст: текст 
каталогиздат: каталогиздат 
форма: формы 
физиологический: физиологический 
порода: породах пород 
водослой: водослоем водослой 
сухой: сухом 
полоса: полос 
цвет: цвет цвету цветом 
май: мая 
подтвердить: подтверждена 
граница: границей 
пропитка: пропитки 
мало: мало 
россия: россии 
лицензия: лицензии 
преимущественно: преимущественно 
один: одна одним 
положение: положение 
ссылка: ссылки 
комель: комле 
пихта: пихты 
водопоглощение: водопоглощения 
изучить: изучены 
зимой: зимой 
разный: разных разной 
год: года 
трещина: трещины трещин 
различаться: различается 
отличие: отличие 
мелкий: мелкие 
зона: зоне 
который: которое которых 
классификация: классификация 
дополнительный: дополнительные 
серовато: серовато 
тон: тонов 
микрофлора: микрофлора 
ильмовый: ильмов 
мочь: могут 
разбухать: разбухает 
внутрь: внутрь 
причина: причиной 
иметь: имеет 
действовать: действовать 
высота: высоты высоту 
полубояринов: полубояринов 
исключение: исключением 
содержание: содержание 
водородный: водородного 
связать: связан 
экз: экз 
примечание: примечания 
отдельный: отдельными отдельных 
газовый: газовым 
второе: второе 
пропитать: пропитанный 
твёрдость: твёрдость 
изменяться: изменяются 
неравномерность: неравномерность 
увлажнить: увлажнённых 
вода: воды водой 
отличаться: отличаются отличается 
буроватый: буровато 
повысить: повышено 
бывать: бывает 
массив: массивом 
качество: качество 
нктп: нктп 
усушка: усушки 
возникновение: возникновение 
здоровый: здоровой 
брожение: брожения 
слоить: слою 
литература: литература 
товарный: товарный 
вокруг: вокруг 
сравнение: сравнению 
морозобоина: морозобоинами 
влияние: влияние 
затруднять: затрудняют 
приобретать: приобретает 
сть: сть 
заболотить: заболоченных 
её: её 
чёткий: чёткой 
бурый: бурый 
черта: чертой 
особенность: особенность 
так: т 
некоммерческий: некоммерческой 
март: марта 
раскол: расколах 
вызываться: вызывается 
вдоль: вдоль 
пром: пром 
водянка: водянка 
обращение: обращения 
образование: образованием 
поэтому: поэтому 
продольный: продольных 
гигроскопичный: гигроскопичнее 
микроскоп: микроскоп 
показатель: показателя 
ссср: ссср 
сучка: сучки 
хвойный: хвойных 
раковый: раковым 
растрескиваться: растрескивается 
архивировать: архивировано 
сильный: сильнее 
окружающий: окружающей 
сжатие: сжатии 
пятно: пятен пятнами 
природа: природа 
щелочной: щелочной 
ядро: ядре 
ствол: ствола 
экспериментально: экспериментально 
проникновение: проникновением 
раствор: растворов 
сильно: сильно 
расти: растущем 
место: месте 
служить: служить 
это: это 
сохранять: сохраняет 
нагрузка: нагрузках 
срок: срока 
открытый: открытые 
уменьшить: уменьшена 
поверхность: поверхности 
волокно: волокон 
назвать: названных 
окрасить: окрашенным 
язва: язвам 
химический: химическую 
волокнистый: волокнистую 
альбом: альбом 
наиболее: наиболее 
избыточно: избыточно 
нормальный: нормальной 
определение: определения 
давление: давлением 
проницаемость: проницаемость 
метан: метана 
древесный: древесных 
ложный: ложном 
есть: ели 
появление: появления 
дождев: дождевой 
термин: термины 
апрель: апреля 
бревно: брёвна 
лесоматериал: лесоматериала 
запах: запахом 
разрез: разрезах 
источник: источник 
сканировать: сканирующий 
