фаза: фазы фаза 
методологический: методологические методологического 
структурно: структурно 
базовый: базовые 
подход: подхода 
общелогический: общелогической общелогические 
способ: способа 
научный: научного научному научной научный научное научных научные 
философский: философских 
концепция: концепции 
принцип: принципы 
оерация: оерация 
тема: темы 
позитивный: позитивной 
структурный: структурные 
теоретический: теоретического теоретических теоретические 
основание: основания 
исследовательский: исследовательской 
эмпирический: эмпирический эмпирических эмпирического 
методика: методика 
рефлексивный: рефлексивная 
общий: общая общие общее 
основа: основе 
средство: средства 
объект: объект 
норма: нормы 
наука: науке наука науки 
классификация: классификации классификация 
этап: этапы этап 
компонент: компоненты 
обеспечение: обеспечении 
метод: методов методу метода методы 
отличие: отличие 
построить: построенные 
статус: статуса 
методология: методологии 
критерий: критерии критериев 
значимость: значимости 
структура: структуры структура 
стадия: стадии 
приём: приемы приема 
предметный: предметная 
уровень: уровня уровни 
особенность: особенности 
категория: категории 
деятельность: деятельности 
признак: признаки 
вопрос: вопросы 
исследование: исследования исследований исследование 
понятие: понятие понятия 
цель: цель 
стрктур: стрктура 
научность: научности 
знание: знания знание 
предмет: предмет 
логический: логической логические 
нормативный: нормативное 
техника: техника 
построение: построение 
организация: организации 
этика: этики 
анализ: анализа 
проблема: проблема 
дескриптивный: дескриптивное 
процедура: процедура 
проект: проект 
четыре: четыре 
предъявлять: предъявляемые 
типология: типология 
требование: требования 
роль: роль 
характеристика: характеристики 
алгоритм: алгоритм 
познание: познания 
общенаучный: общенаучных 
закон: законы 
эвристика: эвристики 
термин: термины 
задача: задачи 
эссе: эссе 
рациональный: рациональной 
теория: теории 
форма: формы 
основной: основные 
