энтузиаст: энтузиастов 
кроме: кроме 
насыпь: насыпям 
линия: линия линии линиям линией линию 
год: гг года годы лет 
валл: валл 
медиафайл: медиафайлы 
являться: являются является 
гелерот: гелерта 
неопределённый: неопределённого 
начало: начала 
постройка: постройки 
условие: условия 
железный: железной железных железную железная 
очередь: очередь 
соглашение: соглашению 
энциклопедия: энциклопедии 
свой: своей 
февраль: февраля 
затем: затем 
узкоколейка: узкоколейки 
вид: виде 
близ: близ 
тепловоз: тепловозы 
трайт: трайт 
тяга: тяги 
маура: маур 
надежда: надежды 
дело: дело 
соответствовать: соответствующее 
сайт: сайт 
соответствующий: соответствующие 
открыть: открыли 
некоммерческий: некоммерческой 
уэльс: уэльс уэльса 
избрать: избран 
право: право 
передать: передан 
бетгелертский: бетгелертский 
новый: новых 
истинный: истинной 
пять: пять 
браун: браун 
депо: депо 
втянуться: втянулась 
другой: другим 
отвести: отведённой 
лицензия: лицензии 
самый: самым 
который: которая которой которое которые которому который 
расширяться: расширялась 
путь: пути путь 
упомянуть: упомянутый 
образовать: образовано 
достаться: досталась 
пассажирский: пассажирские 
бывший: бывшей 
карнарвон: карнарвона карнарвон 
сюда: сюда 
председатель: председателем 
дорога: дороги дорога дорогу дорогой дороге дорогах 
настоящий: настоящим 
материал: материал 
динас: динаса 
производиться: производилась 
обращение: обращения 
использоваться: используются 
длина: длиною 
находиться: находится 
храниться: хранится 
нагорный: нагорной нагорная нагорную 
узкоколейный: узкоколейная узкоколейных 
здание: здания 
великобритания: великобритания 
движение: движение движения 
портмадог: портмадога портмадог 
уайнваура: уайнваура 
носить: носил носила 
выйти: вышел 
построить: построены построенные построенный 
возвести: возведён 
фестиниогский: фестиниогской фестиниогская 
мытарство: мытарств 
состав: состав 
км: км 
участок: участок участка 
реконструкция: реконструкция реконструкцию 
далёкий: дальше 
название: название 
сообщество: сообщество 
послевоенный: послевоенной 
музейный: музейными музейная музейных 
разный: разных 
время: времени время 
компания: компания компанию компании 
пока: пока 
зарегистрировать: зарегистрированный 
округ: округе 
группа: группой 
оригинальный: оригинальной 
северный: северного 
статус: статуса 
рассесть: рассел 
страница: страница 
последний: последний последняя 
август: августа 
экспонат: экспонатами экспонатов 
история: история 
паровозный: паровозный 
архивировать: архивировано 
входить: входил 
земля: земли земля 
несколько: несколько 
случай: случаях 
соседствовать: соседствует 
пора: пор 
место: местах 
подчинение: подчинение 
переименовать: переименованной 
тот: тех 
знак: знак 
состояние: состояние 
мочь: могут 
октябрь: октября 
следующий: следующие 
весьма: весьма 
участие: участие 
пригородный: пригородной 
часть: часть 
соединяться: соединяется 
действовать: действовать 
миля: миль 
законсервировать: законсервирован 
пользоваться: пользовалась 
ранний: раньше 
смотреть: см 
оказаться: оказался 
согласно: согласно 
г: г 
она: ею 
вагон: вагонов вагоны 
применять: применять 
долгий: долгое долгих 
программа: программе 
существовать: существуют существовал 
паровоз: паровоза паровозы паровоз 
строительство: строительства 
отдельный: отдельных 
содержание: содержание 
портмадога: портмадоге 
чиниться: чинился 
соединять: соединяющая 
прокладка: прокладки 
оригинал: оригинала 
ставить: ставило 
википедия: википедии 
исторический: исторической историческая 
мойнт: мойнта мойнт 
викисклад: викискладе 
бетгелерт: бетгелерт бетгелерта 
прежний: прежней прежнюю прежних 
маркетинговый: маркетинговой 
старый: старые 
свободный: свободной 
примечание: примечания 
участвовать: участвует 
дотянуться: дотянется 
станция: станции станция станцией 
работать: работает работавший 
ферма: фермы 
возрождение: возрождение 
июль: июля 
оба: обе 
первый: первая 
основать: основало 
перестраивать: перестраивали 
прислать: пришли 
неоднократно: неоднократно 
продлить: продлено продлить 
великий: великие 
принимать: принимала 
организация: организации 
лтд: лтд 
отношение: отношения 
хозяйственный: хозяйственные 
доступный: доступен 
протяжённость: протяжённость 
кембрийский: кембрийской 
изначально: изначально 
бить: бил 
валлийский: валлийская валлийской валлийском валлийскую 
ветка: ветки 
превратить: превратили 
талиллинский: талиллинской 
получить: получила 
поездной: поездную 
дополнительный: дополнительные 
полотно: полотно 
прежде: прежде 
город: город 
проложить: проложен 
мм: мм 
копия: копиями 
закрытый: закрытую 
приобрести: приобрела 
современный: современное 
произвести: произведя 
страна: страна 
литература: литература 
частый: чаще 
работа: работу работы 
отредактировать: отредактирована 
предназначаться: предназначался 
сарай: сарай 
север: севера 
число: числе 
реконструировать: реконструируемая 
дата: дата 
товарный: товарный 
управление: управления 
каковой: каковым 
дальнейший: дальнейшая 
мойнтом: мойнтом 
англ: англ 
лёгкий: лёгкая 
петля: петли 
неиспользуемый: неиспользуемый 
железнодорожный: железнодорожных 
вагонный: вагонное 
возродить: возродить 
этот: эта 
текст: текст 
пен: пен 
мысль: мыслью 
запасный: запасной 
гуинет: гуинет 
источник: источник 
цель: целью 
активный: активное 
юг: юга 
остановиться: остановилась 
