музыкальный: музыкальные музыкальных 
организатор: организатором организатор 
константи: константи 
работать: работал работать 
медиафайл: медиафайлы 
место: место 
несколько: несколько 
московский: московской 
маркетолог: маркетолога маркетологом 
переехать: переехал 
увеличить: увеличил 
карточка: карточка 
карьера: карьера 
год: год года году годы лет 
радио: радио 
лауреат: лауреатом 
миллион: миллиона 
диджеинга: диджеинга 
условие: условия 
подписчик: подписчиков 
рейтинг: рейтинг рейтинга 
занимать: занимал 
шоу: шоу 
основание: основания 
страница: страница 
люберцы: люберцы 
случай: случаях 
март: марта 
собственный: собственном собственная 
разный: разное 
должность: должность должности 
константин: константина константин константином 
имя: имя 
отредактировать: отредактирована 
мочь: могут 
директор: директора директором директор 
месяц: месяцев 
январь: января 
деятельность: деятельностью деятельности 
стратегический: стратегическим 
анастасия: анастасия 
также: также 
викисклад: викискладе 
июль: июля 
лицензия: лицензии 
момент: момента 
примечание: примечания 
аудитория: аудиторию 
запустить: запустил 
дополнительный: дополнительные 
товарный: товарный 
интервью: интервью 
работа: работе 
российский: российском российский 
сидоркова: сидоркова 
зарегистрировать: зарегистрированный 
дуров: дуровым дурова 
сидорк: сидорков 
бывш: бывш 
партнёр: партнёрами 
заниматься: занимается 
окончить: окончив 
медиаменеджер: медиаменеджер 
содержание: содержание 
спецпроект: спецпроектов 
разговор: разговоров 
коммуникация: коммуникациям 
область: области 
основатель: основателем 
родиться: род родился 
бизнес: бизнесе 
значимость: значимость 
полный: полное 
биография: биография 
н: н 
милан: милана 
гайк: гайк 
знак: знак 
признание: признание 
встреча: встрече 
сидоркий: сидорко 
свой: своим своей 
являться: является 
источник: источник 
возглавить: возглавил 
организация: организации 
ульяновск: ульяновске ульяновск 
проект: проектов проекты 
специальный: специальных 
код: код 
университет: университет 
профессия: профессию 
отдельный: отдельных 
управление: управление управления 
говорить: говорим 
росконгресс: росконгресс 
последний: последний 
фанат: фанат 
текст: текст 
семья: семьёй 
действовать: действовать 
материал: материал 
рождение: рождения 
дать: дал 
фестиваль: фестиваля 
начать: начал 
волна: волне 
сидорков: сидорковым 
рьевич: рьевич 
важный: важном 
февраль: февраля 
декабрь: декабря 
карпов: карпова 
ранее: ранее 
летний: летний 
вместе: вместе 
менеджер: менеджера 
факт: факта 
развитие: развитию 
интернет: интернет 
ежегодный: ежегодного 
диджей: диджей 
дата: дата 
стать: стал 
энциклопедия: энциклопедии 
доступный: доступен 
менеджмент: менеджмент 
помимо: помимо 
сеть: сетей 
некоммерческий: некоммерческой 
основать: основал 
вконтакте: вконтакте 
этот: эта 
время: время 
спикер: спикером 
один: одного 
друг: другом 
занять: занял 
юриевич: юрьевич 
федеральный: федеральным 
город: городе 
головной: головной 
даллакян: даллакян 
радиостанция: радиостанция радиостанцию 
москва: москва 
википедия: википедии 
стояновск: стояновска 
свободный: свободной 
поступить: поступил 
профиль: профиль 
категория: категории 
гражданство: гражданство 
проработать: проработав 
государственный: государственный 
издание: издания 
август: августа 
ю: ю 
россия: россия 
социальный: социальных 
