пианист: пианист 
громкий: погромче 
половина: половины 
копия: копия 
музыкальный: музыкальные музыкальной музыкальных музыкальная 
независимый: независимой 
валентина: валентина 
место: место 
спешить: спешит 
шёнберг: шёнберга 
колонный: колонном 
выказывать: выказываемое 
школа: школу школа школе 
карьера: карьера 
скрябин: скрябина 
мемориальный: мемориальными 
молодой: молодых 
условие: условия 
ссылка: ссылка 
хмельницкий: хмельницкая хмельницкой 
век: века 
г: г 
страница: страница 
педагог: педагогами 
случай: случаях 
общение: общение 
одесса: одесса 
март: марта 
артемьев: артемьев 
старт: старт 
музыка: музыки 
посёлок: посёлок 
концерт: концерт концертами 
отредактировать: отредактирована 
живой: живое 
мочь: могут мог 
день: дня дней день 
январь: января 
фест: фест 
горовица: горовиц 
международный: международного 
репертуар: репертуар 
рутина: рутину 
пошлость: пошлость 
выбрасывать: выбрасывает 
лысенко: лысенко 
кнайфель: кнайфеля 
лицензия: лицензии 
контраст: контрасты 
примечание: примечания 
лев: львов 
государственный: государственной 
университет: университеты 
имя: имени 
произведение: произведений произведения 
дополнительный: дополнительные 
несмотря: несмотря 
альбан: альбана 
товарный: товарный 
зеркало: зеркало 
известный: известен 
интервью: интервью 
консерватория: консерватории консерватория 
дебюсся: дебюсси 
мировой: мировой 
зарегистрировать: зарегистрированный 
средний: среднюю 
киев: киеве киев 
число: числе 
регин: регины 
валентин: валентин 
премия: премии 
требовать: требуемых 
интернат: интернат 
май: мая 
андеграунд: андеграунд 
первый: первый 
форум: форум 
культура: культуры культуре 
мой: мои 
премьера: премьеры 
небо: неба 
заниматься: заниматься 
область: область области 
громов: громовым громова громов 
второй: второй 
это: этим это 
ревуцкий: ревуцкого 
помощь: помощь 
киевский: киевской киевскую 
лауреат: лауреат 
деньга: деньги 
дмитрий: дмитрий 
родиться: род 
летие: летию 
александр: александра 
ды: ды 
малый: малом 
бодырёв: бодырева 
шнитке: шнитке 
академия: академии 
н: н 
русский: русский русской 
знак: знак 
фестиваль: фестивалях фестиваля фестиваль 
фортепиано: фортепиано 
куртаг: куртаг 
дьёрдь: дьёрдь 
архивный: архивная 
район: район района 
источник: источник 
клод: клода 
участник: участником 
каретников: каретникова 
союзный: союзное 
владимирович: владимирович 
евгений: евгений 
деражнянский: деражнянского деражнянский 
организация: организации 
частность: частности 
юбилейный: юбилейный 
год: года году годах лет 
иосиф: иосифа 
ночь: ночи 
галина: галины 
перерыв: перерывами 
сложно: сложно 
оливье: оливье 
булёз: булеза 
десятерик: десятерик 
ящик: ящике 
филармония: филармонии 
зал: зале 
отдельный: отдельных 
украинский: украинских украинской украинский 
мессиана: мессиана 
память: памяти 
проведение: проведении 
последний: последний 
текст: текст 
композитор: композиторами 
государство: государство 
действовать: действовать 
начинать: начиная 
материал: материал 
рождение: рождения 
дать: дал дав 
арнольд: арнольда 
ложа: ложе 
николай: николая 
эдуард: эдуард 
свой: своих 
канчель: канчели 
солярис: солярис 
волковинец: волковинцы 
профессия: профессии 
участвовать: участвовал 
июнь: июня июнь 
программа: программ 
два: две 
новый: новой 
информация: информация 
левко: левко 
альфред: альфреда 
сольный: сольный 
бродский: бродского 
украина: украина украины 
прокрустов: прокрустово 
декабрь: декабря 
национальный: национальной 
берг: берга 
обсуждать: обсуждали 
бешеный: бешеные 
антон: антона 
вместе: вместе 
карлхайнец: карлхайнца 
выступать: выступал 
музик: музик 
схо: схо 
недоступный: недоступная 
российский: российской 
дата: дата 
фортепианный: фортепианной 
энциклопедия: энциклопедии 
штокхаузен: штокхаузена 
уствольский: уствольской 
основный: основных основная 
вече: вече 
доступный: доступен 
быть: е 
гия: гия 
борис: бориса 
некоммерческий: некоммерческой 
этот: эта 
сезон: сезона 
непосредственно: непосредственно 
влиться: влиться 
владимир: владимира 
предпочтение: предпочтение 
исполнение: исполнение 
включать: включает 
пятница: пятница 
посвятить: посвящённых 
википедия: википедии 
сильвестровый: сильвестрова 
свободный: свободной 
веберн: веберна 
слово: словам 
учиться: учился 
лятошинский: лятошинского 
пьер: пьера 
сильвестр: сильвестров 
специальный: специальную 
инструмент: инструменты 
неделя: недели 
август: августа 
выступить: выступил 
пропагандист: пропагандист 
окончить: окончил 
страна: страна 
