босс: боссом 
условие: условия 
смитя: смити 
сюжет: сюжет 
энциклопедия: энциклопедии 
издатель: издателем 
дистрибьютор: дистрибьютор 
мастерсон: мастерсон 
винс: винс 
некоммерческий: некоммерческой 
раздувать: раздувать 
репортёр: репортер репортёр 
лицензия: лицензии 
продать: продано 
анджелес: анджелес 
харрисон: харрисоном 
алан: алан 
ссылка: ссылки 
убийца: убийцу убийца убийцы 
жанр: жанр 
материал: материал 
сняться: снялись 
йенссный: йенссен 
тейлор: тейлор тейлора 
начинать: начинает 
история: историю 
рурк: рурк 
кинокомпания: кинокомпания 
режиссёр: режиссёра режиссёр 
который: которой который 
питер: питер 
год: года год 
зарегистрировать: зарегистрированный 
газетный: газетный 
страница: страница 
автор: автор 
последний: последний 
сша: сша 
пэрри: пэрри 
психопат: психопат 
газета: газет 
случай: случаях 
дополнительный: дополнительные 
телевизионный: телевизионная 
знак: знак 
перрино: перрино 
мочь: могут 
действовать: действовать 
сенсация: сенсации 
вон: вон 
микки: микки 
это: это 
ради: ради 
язык: язык 
отдельный: отдельных 
длительность: длительность 
роберт: роберт 
джада: джада 
кинг: кинг 
википедия: википедии 
порочный: порочного 
шаг: шагов 
страх: страхе 
свободный: свободной 
драма: драма 
мина: мин 
измученный: измученный 
подхлёстывать: подхлёстывает 
розенман: розенман 
роль: ролях 
джад: джад 
сценарий: сценария 
композитор: композитор 
организация: организации 
доступный: доступен 
терроризировать: терроризировать 
город: город 
тони: тони 
безжалостный: безжалостным 
кроуфорд: кроуфордом 
серийный: серийного 
лос: лос 
сайт: сайте 
страна: страна 
июнь: июня 
леонард: леонард 
отредактировать: отредактирована 
дэвид: дэвид 
товарный: товарный 
пэйт: пэйта 
английский: английский 
англ: англ 
эксплуатироваться: эксплуатируется 
отслежка: отслежки 
этот: эта 
текст: текст 
источник: источник 
главный: главных 
