исторический: исторический 
млевский: млевский млевские 
кадниковский: кадниковский кадниковского 
кремлёвский: кремлёвские кремлевский кремлевского 
условие: условия 
вечность: вечности 
диссертация: диссертация диссертацию 
труд: труды 
энциклопедия: энциклопедии 
казан: казан 
первородный: первородный 
сын: сын 
некоммерческий: некоммерческой 
александрович: александрович александровича 
лицензия: лицензии 
портр: портр 
изучать: изучающих 
фамилия: фамилию 
магистриан: магистриан магистриана 
гностик: гностик 
тип: тип 
пособие: пособие 
канон: канон 
ссылка: ссылки 
материал: материал 
вологодский: вологодской вологодская 
анна: анна 
население: населением 
обращение: обращения 
очерк: очерк 
академия: академии 
год: году годах 
императорский: императорским 
патриарх: патриарх 
сменить: сменить 
лопухин: лопухина 
августин: августина 
рюмка: рюмка 
свящий: свящ 
мать: мать 
доктрина: доктрина 
кремлевый: кремлево 
пелагианство: пелагианства 
вопрос: вопросу 
отец: отец 
блаженный: блаженного 
дер: дер 
богослов: богослов 
зарегистрировать: зарегистрированный 
вино: вина 
уна: ун 
мир: миров 
страница: страница 
последний: последний 
уезд: уезд уезда 
смерть: смерти 
магистрианович: магистрианович 
казань: казань 
история: история 
грех: грех 
случай: случаях 
дополнительный: дополнительные 
брат: брату 
изд: изд 
знак: знак 
мочь: могут 
пётр: петра петру 
всероссийский: всероссийский 
действовать: действовать 
русский: русский 
духовный: духовной 
рождение: рождения 
смотреть: см 
указ: указом 
вассианович: вассиановна 
тема: тему 
отдельный: отдельных 
лита: лит 
магистерский: магистерская 
петроград: петроград 
википедия: википедии 
п: п 
христианский: христианский 
пелагианский: пелагианская 
иппонский: иппонского 
ярославский: ярославского 
разрешить: разрешено 
свободный: свободной 
законоучитель: законоучитель законоучителя 
л: л 
александр: александр александру 
мучение: мучений 
родиться: родился 
корпус: корпуса 
кремлёвый: кремлёво 
деревня: деревне 
санкт: санкт 
организация: организации 
кре: кре 
жданов: жданова 
учение: учению 
шайтан: шайтанов 
считать: считать 
губерния: губерния губернии 
доступный: доступен 
маркион: маркион 
м: м 
ярослый: яросл 
гроб: гробом 
священник: священника священник 
кадетский: кадетского 
опасный: опасна 
петербург: петербург 
ноябрь: ноября 
гермоген: гермоген 
типо: типо 
кузнецов: кузнецова 
июнь: июня 
зло: зло 
катехизис: катехизис 
отредактировать: отредактирована 
казанский: казанской 
небожитель: небожители 
учиться: учился 
место: место 
дата: дата 
ангел: ангелов 
товарный: товарный 
млевый: млево 
шайтановый: шайтанова 
православный: православный 
этот: эта 
текст: текст 
звёздный: звёздных 
источник: источник 
защитить: защитил 
основной: основные 
личность: личность 
тот: та 
