копия: копия 
ноябрь: ноября 
лондон: лондон лондоне 
гимнастика: гимнастике гимнастика 
место: место 
появиться: появилась 
начинать: начинала 
состав: состав 
орден: орден 
карьера: карьера 
медаль: медали 
команда: команды 
четверг: четверг 
достижение: достижения 
федерация: федерации 
условие: условия 
групповой: групповое групповые групповом 
указ: указ 
токио: токио 
мастер: мастер 
ксения: ксения ксенией ксении 
алина: алина 
оригинал: оригинала 
г: г 
распоряжение: распоряжение 
страница: страница 
сингапур: сингапуре 
ирина: ирина 
вес: вес 
чемпионат: чемпионата чемпионаты 
март: марта 
случай: случаях 
севастьянов: севастьянова 
лента: ленты 
омск: омск омске 
высокий: высокие 
упражнение: упражнения 
имя: имя 
отредактировать: отредактирована 
мочь: могут 
развитие: развитие 
личный: личная 
январь: января 
награждение: награждении 
евгения: евгении 
анастасия: анастасия 
дудкин: дудкина дудкиной 
присвоение: присвоении 
женский: женский 
пол: пол 
самый: самый 
июль: июля 
лицензия: лицензии 
елена: елена елены 
примечание: примечания 
ссылка: ссылки 
российский: российская российской 
дополнительный: дополнительные 
европа: европы 
товарный: товарный 
павлович: павловна 
интервью: интервью 
специализация: специализация 
бронза: бронза 
россия: россии россия 
зарегистрировать: зарегистрированный 
олимпийский: олимпийская олимпийских олимпийские 
универсиада: универсиады универсиаде 
серебро: серебро 
архивировать: архивировано 
физический: физической 
обращение: обращения 
игра: играх игр игры 
содержание: содержание 
спортивный: спортивные спортивный спортивного спортивная 
май: мая 
рост: рост 
конференция: конференция 
культура: культуры 
золото: золото 
сайт: сайте 
заниматься: заниматься 
мяч: мячей мяча 
нг: нг 
большой: большой 
сергаев: сергаева 
макаренко: макаренко 
член: член 
полный: полное 
биография: биография 
конкурентка: конкурентка 
летний: летней 
знак: знак 
архивный: архивная 
донсков: донскова 
ульяна: ульяна 
источник: источник 
многоборье: многоборье 
юношеский: юношеских 
организация: организации 
рп: рп 
смотреть: см 
пресс: пресс 
год: года лет 
великобритания: великобритания 
новгород: новгород 
государственный: государственными государственные 
инна: инна 
каролина: каролина 
хотеться: хотелось 
поощрение: поощрении 
татьяна: татьяна 
приказ: приказ 
отдельный: отдельных 
нижний: нижний 
последний: последний 
художественный: художественной художественная 
звание: звания 
текст: текст 
президент: президента 
действовать: действовать 
быстров: быстрова 
материал: материал 
рождение: рождения 
монпелье: монпелье 
участие: участием 
казань: казань казани 
награда: наградами награды 
основной: основной 
сборная: сборной 
почётный: почётная почётного 
радость: радости 
булава: булав 
спорт: спорта спортом 
канаев: канаева канаевой 
информация: информация 
февраль: февраля 
змс: змс 
грамота: грамота 
дружба: дружбы 
сентябрь: сентября 
всемирный: всемирной 
молодой: молодой 
вклад: вклад 
олимпиада: олимпиады 
заслужить: заслуженный 
чемпионка: чемпионка 
минспорттуризм: минспорттуризма 
дата: дата 
энциклопедия: энциклопедии 
доступный: доступен 
винер: винер 
николаевич: николаевны 
некоммерческий: некоммерческой 
арайса: арайс 
кг: кг 
назаренко: назаренко 
октябрь: октября 
этот: эта 
плакать: плакать 
киев: киев 
город: городе 
пройти: прошла 
близнюк: близнюк 
завоевать: завоевали 
википедия: википедии 
свободный: свободной 
профиль: профиль 
мир: мира 
ведомственный: ведомственные 
апрель: апреля 
гимнастка: гимнастка 
август: августа 
предположительно: предположительно 
тренер: тренеры 
страна: страна 
