движок: движке движок 
известно: известно 
поражение: поражения 
исход: исхода исход 
класс: классов классами класс классы 
команда: команды командой команда 
должный: должна 
дополнительный: дополнительная дополнительные 
продажа: продажи 
страница: страница 
точный: точное точных 
танк: танки 
оказываться: оказываются 
зенитка: зенитки 
чей: чей 
игровой: игровой 
эффективный: эффективен 
контроль: контроля контроль 
активация: активации 
сторона: сторонами 
оружие: оружием оружие 
атака: атаке атак атака 
смерть: смерти 
они: ними 
обладать: обладает 
объект: объекты объектов 
два: двумя две 
дальнобойный: дальнобойные дальнобойное 
архивировать: архивировано 
поддержка: поддержкой поддержка 
менее: менее 
первый: первый первого 
убитый: убитый убитые 
выстрел: выстрелов выстрелу выстрелом 
целик: целик 
официальный: официальный 
изготовка: изготовки изготовка 
знак: знак 
лицо: лица 
подбираться: подбирается 
укрепить: укреплённых 
участник: участник 
средний: средняя средней среднюю 
каждый: каждой каждый 
год: года 
снайпер: снайперами снайперов снайпер 
привязываться: привязываются 
совместимый: совместимая 
отдельный: отдельных 
управление: управление 
этот: этому эта 
дымовой: дымовое дымовая 
бой: боя бою бой 
действовать: действовать 
захватить: захватить 
который: который которого которые которой 
детализация: детализация 
текстура: текстур 
неконтролируемый: неконтролируемое 
наоборот: наоборот 
разработка: разработка 
нужно: нужно 
игрок: игроки игрок игрока игроков 
пользователь: пользователей 
обновление: обновления 
показывать: показывает 
определённый: определённое определённого 
перезарядка: перезарядку 
истечение: истечения 
подкрепление: подкрепления подкреплений 
расстояние: расстояниях 
платформа: платформе платформы 
некоторый: некоторое некоторых 
любой: любой 
полуавтоматический: полуавтоматическим полуавтоматический 
взорвать: взорвать 
таймер: таймер таймеру 
играть: играли играя 
наблюдать: наблюдать 
уничтожение: уничтожение уничтожения 
мощность: мощность 
википедия: википедии 
захват: захват захвата 
игра: игры игра игру игре 
гранат: гранатами гранаты 
идеальный: идеален 
упор: упор 
комбинированный: комбинированные 
принцип: принципу 
обеспечение: обеспечения 
штурмовик: штурмовик 
дистрибуция: дистрибуция 
несколько: несколько 
ракета: ракетами 
флаг: флаги флагов 
малый: меньшую 
позволять: позволяет 
сайт: сайт 
союзник: союзниками 
оценка: оценку 
шесть: шестью шести 
осколочный: осколочная 
иметь: имеет имея 
случай: случаях случае 
март: марта 
многопользовательский: многопользовательский 
пригодный: пригоден 
рейтинг: рейтинги 
ссылка: ссылки 
время: времени время 
носитель: носители 
уязвимый: уязвим 
использовать: использует используя 
товарный: товарный 
прикрытие: прикрытия прикрытие 
одновременный: одновременного 
командный: командную 
хотя: хотя 
связь: связи 
издатель: издатель 
минимальный: минимальные 
положительный: положительные 
устанавливать: устанавливает 
графика: графика 
возрастной: возрастные 
версия: версия 
являться: является 
источник: источник 
заряд: заряд зарядов 
организация: организации 
др: др 
рядом: рядом 
винтовочный: винтовочные 
композитор: композитор 
создать: созданная 
майк: майк 
сделать: сделано сделан 
стрелка: стрелок 
максимально: максимально 
точка: точек 
защитить: защитить 
гб: гб 
схожий: схожему 
удерживать: удерживать 
вид: вид 
радиус: радиус 
возвращаться: возвращаются 
мощный: мощная мощное 
карта: карты карте 
стрелять: стреляет 
режим: режиме режимы режим режимами 
сентябрь: сентября 
лето: летом 
обзор: обзоров 
доступный: доступен 
мушка: мушку 
интерфейс: интерфейса 
взрыв: взрыв 
составлять: составляет 
прицеливание: прицеливания 
вражеский: вражеских 
выбирать: выбирает 
успех: успеха 
создатель: создатели 
автоматический: автоматическое автоматическим 
просто: просто 
наиболее: наиболее 
тактика: тактику 
достижение: достижения 
условие: условия 
видеокарта: видеокарта 
язык: язык 
оставаться: остаётся 
фиксировать: фиксированная 
эффективно: эффективно 
мочь: могут 
убойный: убойная 
гранатомётчик: гранатомётчик 
июль: июля 
английский: английский 
лицензия: лицензии 
оборона: обороны 
кулак: кулаком 
универсальный: универсальный 
вооружение: вооружении 
часть: частью 
винтовка: винтовка 
удар: удар 
одновременно: одновременно 
отдача: отдача 
требоваться: требуется 
получить: получила 
другой: другие 
процесс: процесс 
обращение: обращения 
содержание: содержание 
скорострельность: скорострельность скорострельностью 
зона: зона 
значительный: значительное 
координация: координации 
роль: роль 
немецкий: немецкий немецкая 
сошка: сошки сошек сошках 
друг: друг другом 
благодаря: благодаря 
технический: технические 
требовать: требуют 
установленный: установленных 
шутереть: шутер 
точность: точности точность 
пулемётчик: пулемётчиками пулемётчиков пулемётчик 
победа: победы 
инициировать: инициирует 
прицел: прицела прицел 
сила: сила 
преимущественно: преимущественно 
вооружённый: вооружённый 
карабин: карабин 
движение: движении 
дальность: дальности 
перегреться: перегреться 
присутствие: присутствия 
защита: защиты защите 
повлиять: повлиять 
переиздание: переиздание 
декабрь: декабря 
отыгрывать: отыгрывает 
оз: озу 
оптический: оптический 
уязвимость: уязвимости 
дата: дата даты 
система: систему 
фланговый: флангов 
мораск: мораски 
разработчик: разработчик 
человек: человек 
достаточно: достаточно 
больший: большей 
свободный: свободной 
сражение: сражением 
задача: задачи 
дальний: дальних 
становиться: становится 
солдат: солдат 
компьютерный: компьютерной 
агрегатор: агрегатор 
стрельба: стрельбы 
позиция: позиций 
ггц: ггц 
пространство: пространство 
обеспечить: обеспечить 
ближний: ближнего ближнем 
улучшить: улучшена 
дать: данные 
оглушить: оглушёнными 
сервис: сервиса 
простреливать: простреливать 
возрождаться: возрождаются 
уничтожать: уничтожать 
отредактировать: отредактирована 
раунд: раунде 
системный: системные 
ручной: ручную 
помощь: помощью 
борьба: борьбы 
третий: третьи 
процессор: процессор 
примечание: примечания 
нести: нести 
низкий: низкая низкой 
стать: стало 
территория: территорией территории 
зарегистрировать: зарегистрированный 
выпуск: выпуска 
летальный: летального 
обновить: обновлённая 
май: мая 
взрывчатка: взрывчатки 
американский: американский 
взрываться: взрывающимися 
цель: целью 
воевать: воюющими 
соединение: соединение 
частность: частности 
взаимодействовать: взаимодействуют 
обозначить: обозначенные 
мб: мб 
очень: очень 
жанр: жанр 
портировать: портирована 
пробежать: пробежать 
необходимо: необходимо 
последний: последний 
различный: различных 
текст: текст 
материал: материал 
клавиатура: клавиатура 
основание: основании 
пережить: пережившие 
серьёзно: серьёзно 
поверхность: поверхности 
остальной: остальные 
интернет: интернетом 
полностью: полностью 
количество: количество 
мышь: мышь 
уникальный: уникальное 
февраль: февраля 
англ: англ 
вермахт: вермахтом 
требование: требования 
течение: течение 
отзыв: отзывы 
энциклопедия: энциклопедии 
некоммерческий: некоммерческой 
подключиться: подключившись 
изготовиться: изготовиться 
цифровой: цифровая 
встроить: встроенную 
нахождение: нахождения 
крайне: крайне 
появление: появления 
огонь: огонь 
апрель: апреля 
перегреваться: перегревается 
расположить: расположенные 
опасный: опасный 
