игра: игр играх 
дойти: дошла 
условие: условия 
югославия: югославия 
москва: москва москву 
энциклопедия: энциклопедии 
февраль: февраля феврале 
выступать: выступать выступавшей выступавшая 
клуб: клуб 
чемпионат: чемпионата 
баскетболистка: баскетболисткой баскетболистка 
кипр: кипра 
телек: телеком 
некоммерческий: некоммерческой 
март: марта 
россия: россии россию 
лицензия: лицензии 
бечирович: бечирович 
фиб: фиба 
ссылка: ссылки 
европа: европа европы 
материал: материал 
обращение: обращения 
достижение: достижения 
форвард: форварда форвард 
кубок: кубка кубке 
внимание: внимание 
хорватия: хорватии 
московский: московский 
герцеговина: герцеговины герцеговина 
финалист: финалист 
загреб: загреб 
адриатический: адриатической 
завершить: завершила 
год: года 
зарегистрировать: зарегистрированный 
пополнить: пополнила 
страница: страница 
азр: азры азра 
последний: последний 
шибеникнуть: шибеник 
август: августа 
случай: случаях 
единство: единство 
архивировать: архивировано 
дополнительный: дополнительные 
лига: лиги 
знак: знак 
мочь: могут 
действовать: действовать 
смотреть: см 
рождение: рождения 
приехать: приехала 
финал: финала 
отдельный: отдельных 
единственный: единственной 
республика: республика 
википедия: википедии 
дбс: дбс 
родиться: род 
гражданство: гражданство 
свободный: свободной 
примечание: примечания 
социалистический: социалистическая 
статистика: статистика 
обратить: обратил 
серебряный: серебряный 
женский: женской 
она: неё 
организация: организации 
призёр: призёр 
позиция: позиция 
доступный: доступен 
босна: босн 
первенство: первенстве 
карьера: карьеру 
кроатия: кроатия 
босния: босния боснии 
боснийский: боснийская 
являться: является 
команда: команды команде 
аел: аел 
череда: череды 
полсезон: полсезона 
травма: травм 
отредактировать: отредактирована 
рост: рост 
место: место 
российский: российском 
дата: дата 
товарный: товарный 
чемпион: чемпион 
сыграть: сыграла 
лимасол: лимасол 
амплуа: амплуа 
англ: англ 
бк: бк 
банович: бановичи 
этот: эта 
текст: текст 
источник: источник 
джолли: джолли 
жбк: жбк 
тузел: тузла 
