приблизительно: приблизительно 
утверждение: утверждении 
тёплый: тёплого тёплым тёплый 
федеральный: федеральная федеральный 
природный: природных 
холодный: холодной 
этный: этно 
населить: населённых 
состав: состав 
тайга: тайги 
федерация: федерации 
условие: условия 
согласно: согласно 
зона: зон зоне 
национальный: национальный национальной 
омаома: омаома 
сайт: сайт 
страница: страница 
г: г 
характеризоваться: характеризуется 
абсолютный: абсолютная абсолютный 
месяц: месяца 
случай: случаях 
март: марта 
воздух: воздуха 
государственный: государственная 
холодное: холодного 
составлять: составляли составляет 
отредактировать: отредактирована 
мочь: могут 
б: б 
январь: января 
смещение: смещение 
результат: результатам 
температура: температура 
перепись: переписи 
относительно: относительно 
июль: июля 
административный: административного 
лицензия: лицензии 
структура: структуре 
сам: самого 
примечание: примечания 
континентальный: континентальный 
время: времени время 
администрация: администрации 
дополнительный: дополнительные 
товарный: товарный 
сельский: сельское сельского 
индекс: индекс 
цифровой: цифровые 
высота: высота 
климат: климат 
город: города 
весь: вся 
год: годов года 
россия: россии россия 
зарегистрировать: зарегистрированный 
далее: д 
информационный: информационная 
планирование: планирования 
центр: центра 
муниципальный: муниципального муниципальный 
статья: статья 
часть: часть части 
архивировать: архивировано 
перечень: перечня 
обращение: обращения 
население: население населения 
содержание: содержание 
май: мая 
южный: южной 
костромской: костромская костромском костромского костромской 
область: область области 
умеренно: умеренно 
юго: юго 
русский: русские 
м: м 
мм: мм 
уровень: уровнем 
министерство: министерства 
официальный: официальный 
многоснежный: многоснежной 
система: система 
знак: знак 
численность: численность 
очерк: очерк 
район: район районе района районов 
источник: источник 
московский: московское 
организация: организации 
поселение: поселение поселения 
средний: средняя 
применять: применяемого 
р: р 
западный: западной 
территориальный: территориального 
широта: ш 
самсоновский: самсоновское самсоновского 
код: код 
право: правом 
фгис: фгис 
закон: закон 
приказ: приказ 
отдельный: отдельных 
пьяньковый: пьяньково 
данные: данных 
история: история 
ресурс: ресурсов 
последний: последний 
зимой: зимой 
план: план 
текст: текст 
атмосферный: атмосферных 
почтовый: почтовый 
окато: окато 
лесорастительный: лесорастительных 
действовать: действовать 
генеральный: генеральный 
автодорога: автодороги 
материал: материал 
запад: западу 
идентификатор: идентификаторы 
пояс: пояс 
всероссийский: всероссийские 
лесной: лесных 
июнь: июня 
реестр: реестра 
постановление: постановление 
пункт: пунктов 
фз: фз 
река: реки 
часовой: часовой 
больший: большая 
география: география 
количество: количество 
подзона: подзоне 
исчисление: исчислении 
февраль: февраля 
кубань: кубани 
продолжительный: продолжительной 
коряк: коряков 
расстояние: расстоянии 
тп: тп 
языковой: языковой 
лето: летом 
море: моря 
осадки: осадков 
российский: российской 
входить: входит 
октмый: октмо 
годовой: годовое 
энциклопедия: энциклопедии 
кострома: костромы 
дата: дата 
доступный: доступен 
база: база 
некоммерческий: некоммерческой 
берег: берегу 
метр: метров 
который: которых 
этот: эта 
находиться: находится 
сравнительно: сравнительно 
короткий: коротким 
выпадать: выпадает 
юг: югу 
деревня: деревня 
географический: географический 
человек: человек 
период: период 
москва: москва 
википедия: википедии 
свободный: свободной 
чел: чел 
мск: мск 
километр: километров 
субъект: субъект 
апрель: апреля 
прямой: прямой 
ю: ю 
максимум: максимум 
страна: страна 
