пределение: пределение 
направление: направление 
переговоры: переговоры 
тарантино: тарантино 
великобритания: великобритании 
ы: ы 
процесс: процессов процессами 
искусство: искусство 
обеспечение: обеспечение 
очный: очная 
исследовательский: исследовательский исследовательской исследовательская 
й: й 
построение: построение 
зрение: зрения 
национальный: национальный 
инженерный: инженерный 
парламентаризм: парламентаризма 
страноведение: страноведение 
наука: науке науки 
фцт: фцт 
выборный: выборных 
федеральный: федеральное 
модуль: модулей модуль модули 
контроль: контроля 
личный: личная 
подготовка: подготовки подготовка 
команда: командой командах 
практика: практика практики 
состояние: состояния состояниями 
поэтический: поэтические 
сеть: сети 
начало: начала 
ипкн: ипкн 
принятие: принятие принятия 
функциональный: функционального функциональное 
участие: участие 
письмо: письма писем письмо 
вид: виды 
далее: д 
эффективность: эффективность 
язык: языки языке язык языка языках 
магистр: магистры 
актуальный: актуальные актуальное 
система: системы систем 
деловой: деловая деловых 
обезвредить: обезвредить 
технология: технологии технологий 
фпи: фпи 
русский: русский 
учебный: учебный 
министерство: министерство 
автоматизация: автоматизация 
ак: ак 
год: года год 
алгоритм: алгоритмы 
университет: университет университета 
физика: физика 
метафора: метафоры 
клеточный: клеточной 
квантовый: квантовая 
анализ: анализ анализа 
данные: данных 
управление: управление управления 
апр: апр 
удалённый: удаленных 
игра: игр 
инвестирование: инвестирования 
эффективный: эффективной эффективного эффективное 
интеллект: интеллект 
тинт: тинт 
собеседование: собеседовании 
вычисление: вычисления 
биохимия: биохимия 
вычислительный: вычислительная вычислительное 
образовательный: образовательной образовательное 
подготовый: подготова 
высокий: высшего 
разработка: разработка разработки разработке 
медиатеория: медиатеорию 
ч: ч 
коммуникация: коммуникации коммуникация 
инфокоммуникационный: инфокоммуникационные 
лаб: лаб 
пул: пул 
путеводитель: путеводитель 
высоконагруженный: высоконагруженных 
итмый: итмо 
фронтенд: фронтенд 
испанский: испанский 
проектирование: проектирования проектированию 
креативность: креативности 
учреждение: учреждение 
проф: проф 
контент: контенте 
запуск: запуска 
фитип: фитип 
современный: современная современное 
сложный: сложная 
проектный: проектно 
общеуниверситетский: общеуниверситетские 
молодой: молодого молодых 
машинный: машинного 
фэт: фэт 
оаобд: оаобд 
исследование: исследований 
ресурсный: ресурсными 
этика: этики 
веб: веб 
федерация: федерации 
проект: проекта 
методология: методология 
курс: курс курсам 
ф: ф 
капитал: капитал 
семестр: семестрам семестре семестр 
сфера: сфере 
эмоциональный: эмоциональный эмоционального 
час: часов 
фикт: фикт 
связь: связи 
устойчивый: устойчивого 
срок: срок 
преддипломный: преддипломная 
блокчейн: блокчейн 
экономика: экономики экономике 
профессиональный: профессиональной профессиональная 
бизнес: бизнес 
м: м 
чаплин: чаплина 
витша: витш 
кол: кол 
сексология: сексологии 
регуляция: регуляция 
н: н 
дизайн: дизайн 
конфликт: конфликтом 
самопрезентация: самопрезентации 
автостоп: автостопом 
китайский: китайский 
трудоголизм: трудоголизм 
организация: организации организация 
деятельность: деятельности 
мф: мф 
бд: бд 
кт: кт 
вкр: вкр 
компьютерный: компьютерных компьютерные 
найти: найти 
механизм: механизмов 
план: план 
программирование: программировании программирование 
ненасильственный: ненасильственное 
архитектура: архитектура 
влияние: влияния 
вокальный: вокальная 
производственный: производственная 
щ: щ 
оп: оп 
академический: академического академическое 
навык: навыки 
популярный: популярном 
котлин: котлин 
л: л 
лаборатория: лаборатория 
дисциплина: дисциплин дисциплины 
свой: своей 
государственный: государственное государственная 
когнитивный: когнитивные 
поиск: поиск 
микроконтроллер: микроконтроллеры 
ресурсосбережение: ресурсосбережении 
культура: культуре 
экспериментальный: экспериментальные 
п: п 
инструмент: инструменты 
научно: научно 
диспозитив: диспозитивы 
инновационный: инновационной 
научный: научная научных 
киноисследование: киноисследования 
программа: программы 
моделирование: моделирование 
информативный: информативная 
итоговый: итоговая 
наименование: наименование 
просто: просто 
антиутопия: антиутопиям 
пр: пр 
основа: основы 
английский: английского английском 
практический: практического практических 
прокрастинация: прокрастинации 
компилятор: компиляторы 
г: г 
мр: мр 
получение: получения 
перевод: перевод 
воображение: воображения 
обязательный: обязательные 
программный: программной программное 
иностранный: иностранный 
карьера: карьерой 
операционный: операционные 
параллельный: параллельные 
дополнительный: дополнительные 
универсальный: универсальный 
выгорание: выгорание 
ц: ц 
биология: биологии 
ректор: ректор 
объём: объем 
часть: часть 
факультатив: факультативы 
кибернетика: кибернетика 
время: временем 
ед: ед 
циия: циия 
структура: структуры 
технологический: технологическая 
языковой: языковые 
исследователь: исследователей исследователя 
графический: графические 
выбор: выбор 
распределение: распределение 
р: р 
реализация: реализации 
широта: ш 
подбор: подбор 
история: история 
системный: системное 
ь: ь 
микс: микс 
микроэкономика: микроэкономика 
васильев: васильев 
первый: первом 
высокопроизводительный: высокопроизводительные 
российский: российского российской 
защита: защите защита 
семесто: семест 
аттестация: аттестации аттестация 
теория: теория теории 
персонал: персонала 
цсио: цсио 
э: э 
инженерия: инженерии 
менеджмент: менеджмент 
видеокарта: видеокартах 
опс: опс 
музыковедение: музыковедение 
креативный: креативное креативные 
фантастика: фантастика 
гиа: гиа 
распределённый: распределенных 
принцип: принципы 
сша: сша 
решение: решений 
автономный: автономное 
протокол: протоколы 
введение: введение 
оф: оф 
наём: найма 
метод: методы 
общение: общение 
база: базы 
текстовый: текстовых 
интерфейс: интерфейсы 
б: б 
блок: блок 
физф: физф 
раздел: разделы 
грамматика: грамматика 
помощь: помощью 
уровень: уровень 
составление: составление 
танцевальный: танцевальная 
компьютер: компьютера 
цель: цели 
энергетика: энергетике 
магистратура: магистратура магистратуры 
з: з 
информационный: информационный 
человеческий: человеческий 
обучение: обучения 
лек: лек 
мышление: мышление 
ноцм: ноцм 
финансовый: финансовой 
мобильный: мобильная 
фтмить: фтми 
криптографический: криптографические 
углублённый: углубленный 
общий: общий 
хбк: хбк 
различный: различных 
конференция: конференциях 
продвинуть: продвинутый 
международный: международных 
лапа: лап 
ошибка: ошибки 
специальный: специальные 
так: т 
грамотность: грамотности 
весенний: весенний 
это: это 
макроэкономика: макроэкономика 
утверждать: утверждаю 
работа: работа 
форма: форма 
быть: е 
основный: основная 
жизнь: жизнь 
техника: техники 
осенний: осенний 
применение: применение 
развитие: развития 
институт: институт 
скриптовый: скриптовые 
глава: главы 
образование: образования 
факультативный: факультативные 
импровизация: импровизация 
