гонка: гонке гонка гонках 
финишировать: финишировали финишировал 
состоять: состоит 
чемпионат: чемпионат чемпионате чемпионаты 
медиафайл: медиафайлы 
ноябрь: ноября 
калгари: калгари 
нидерланды: нидерландов 
место: место 
результат: результатом результаты 
нюнорск: нюнорск 
позади: позади 
ребекка: ребеккой 
карьера: карьера 
хенриксен: хенриксен хенриксена 
медаль: медали медаль медалью 
конькобежный: конькобежном конькобежный конькобежным конькобежному 
команда: команды 
норвегия: норвегия 
конькобежец: конькобежец конькобежцев конькобежцы 
фр: фр 
первый: первыми 
русый: рус 
условие: условия 
ссылка: ссылка ссылки 
спорт: спорту спорт спорта спортом 
оставить: оставив 
инцелля: инцелль 
страница: страница 
спортсмен: спортсмену 
случай: случаях 
март: марта 
высокий: высокие 
возраст: возраста 
норвежский: норвежской норвежский норвежские 
отредактировать: отредактирована 
мочь: могут 
семикратный: семикратный 
завершиться: завершилось завершилась 
отвести: отвёл 
международный: международного 
зимний: зимних 
также: также 
викисклад: викискладе 
синдр: синдре 
третий: третье 
выиграть: выиграл 
июль: июля 
лицензия: лицензии 
примечание: примечания 
норвежец: норвежцы 
дополнительный: дополнительные 
тренер: тренер 
товарный: товарный 
бронза: бронза 
отец: отец 
знакомый: знакомому 
отвечать: отвечает 
стадион: стадионе 
корея: корее 
профессионально: профессионально 
каннын: каннын каннына 
олимпийский: олимпийская олимпийских олимпийский олимпийские 
зарегистрировать: зарегистрированный 
тренироваться: тренируется 
заявить: заявлен 
серебро: серебро 
союз: союза 
позиция: позиции 
этап: этапов 
овал: овал 
архивировать: архивировано 
уотерспун: уотерспун 
обращение: обращения 
игра: играх игр игры 
содержание: содержание 
подготовка: подготовку 
конькобежка: конькобежкой 
золото: золото 
уступить: уступив 
южный: южной 
сайт: сайте 
заниматься: заниматься 
зачёт: зачёте 
м: м 
родиться: род родился 
выступление: выступление 
зеландия: зеландии 
биография: биография 
южнокорейский: южнокорейском 
соперник: соперников соперникам 
состав: составе 
знак: знак 
занять: заняли занял 
источник: источник 
организация: организации 
командный: командных командной командная 
год: года лет 
ставангер: ставангер ставангера 
общий: общем общая 
новость: новости 
дистанция: дистанциях 
золотой: золотой золотую 
берген: берген 
отдельный: отдельных 
кубок: кубка 
джереми: джереми 
свой: своему 
преследование: преследования 
последний: последний последнее 
текст: текст 
энциклопедия: энциклопедия энциклопедии 
действовать: действовать 
материал: материал 
рождение: рождения 
воспитание: воспитание 
пхёнчхан: пхёнчхан 
бронзовый: бронзовой бронзовый 
сборная: сборной 
скавхеллен: скавхеллен 
начать: начал 
забег: забеге 
отношение: отношениях 
новый: новой 
информация: информация 
участие: участия 
коммуна: коммуне 
февраль: февраля 
декабрь: декабря 
национальный: национальной 
англ: англ 
база: базе 
канадский: канадский 
сентябрь: сентября 
университет: университете 
рекорд: рекорды 
личный: личные 
физический: физическое 
клуб: клуба 
норв: норв 
спортивный: спортивная 
недоступный: недоступная 
восьмилетний: восьмилетнего 
дата: дата 
доступный: доступен 
статистика: статистика 
быть: е 
некоммерческий: некоммерческой 
октябрь: октября 
метр: метров 
этот: эта 
сезон: сезона 
разный: разных 
мужчина: мужчины 
мужской: мужской 
город: городе 
википедия: википедии 
призёр: призёр 
свободный: свободной 
профиль: профиль 
обновление: обновление 
мир: мира 
специальность: специальности 
тренировка: тренировки 
гражданство: гражданство 
обучаться: обучался 
