простой: прост простой 
иерусалимский: иерусалимская иерусалимской 
святой: святого святые святой 
смотреть: смотрящие 
место: место месте места 
честь: честь 
отмечать: отмечающий 
женщина: женщинам женщины 
остановка: остановку остановке остановка 
позади: позади 
крестный: крестного 
год: год годах 
хабад: хабад 
иметься: имеется 
крест: крест крестом 
второй: вторым 
условие: условия 
согласно: согласно 
голгофа: голгофой голгофа 
сайт: сайт 
интерьер: интерьер 
основание: основания 
гибель: гибель 
страница: страница 
иерусалим: иерусалим иерусалиме иерусалима 
латинский: латинским 
церковь: церковь церкви 
случай: случаях 
март: марта 
старое: старого 
рь: рь 
отредактировать: отредактирована 
мочь: могут 
действовать: действующий действовать 
заставлять: заставляют 
предание: преданию 
монастырь: монастыря монастырь монастыри 
харлампий: харлампиев 
араб: араб 
лицензия: лицензии 
примечание: примечания 
ссылка: ссылки 
осуждение: осуждении 
нести: нести 
дополнительный: дополнительные 
недалеко: недалеко 
товарный: товарный 
помочь: помочь 
город: города городе 
зарегистрировать: зарегистрированный 
далее: д 
пилат: пилата 
окружный: окружен 
день: дни 
решение: решение 
архимандрит: архимандрит 
вновь: вновь 
часть: часть 
симона: симона 
израиль: израиль 
обращение: обращения обращение 
содержание: содержание 
май: мая 
православие: православие 
христос: христос христа 
ханка: ханка 
виа: виа 
народ: народа 
коробкин: коробкина 
победитель: победитель 
камень: камень 
официальный: официальный 
расположить: расположен 
знак: знак 
паломничество: паломничества 
находиться: находятся находится 
ашлихой: ашлихим 
долороза: долороза 
источник: источник 
издалёка: издалека 
осудительный: осудительное 
организация: организации 
святыня: святыни 
врата: врата 
киринеянин: киринеянина 
западный: западной 
православный: православной православная 
надпись: надписью 
назвать: назван 
широта: ш 
иисус: иисуса иисус 
работа: работы 
христианский: христианском христианского 
старый: старом 
икона: иконы икона 
ведение: ведения 
воин: воинами 
отдельный: отдельных 
история: история 
традиция: традиция 
настоятель: настоятель 
последний: последний последние последнее 
путь: пути 
текст: текст 
храм: храме 
материал: материал 
состояние: состояние 
восьмой: восьмую восьмой 
архитектура: архитектура 
стена: стене 
совершить: совершено 
паломнический: паломнические 
так: т 
спаситель: спасителя 
ариадна: ариадны 
видный: видна 
стояние: стояние 
невидимый: невидимые 
впереди: впереди 
иконостас: иконостас 
монаст: монасты 
предсказать: предсказав 
распятие: распятие 
фотография: фотографии 
квартал: квартале 
путеводитель: путеводитель 
построить: построен 
нить: нить 
дата: дата 
энциклопедия: энциклопедии 
местоположение: местоположение 
доступный: доступен 
бейт: бейт 
толпа: толпа 
судный: судные 
пришествие: пришествием 
некоммерческий: некоммерческой 
этот: эта 
церковный: церковному 
каллиста: каллист 
греча: греч 
харалампия: харалампия 
улица: улице 
мужской: мужской 
достаточно: достаточно 
посредственный: посредственной 
википедия: википедии 
свободный: свободной 
х: х 
обратиться: обратился 
лк: лк 
предположительно: предположительно 
шестой: шестая 
произойти: произошло 
конфессия: конфессия 
страна: страна 
